My Grusome Tomato Kill
An Interactive Fiction by PCAD
Release 1 / Serial number 250910 / Inform 7 build 6M62 (I6/v6.34 lib 6/12N) SD

upon closer inspection the tomato basket is rather moldy

>climb on table
You can't see any such thing.

>climb on old table
You can't see any such thing.

>l
Classroom
It's a delightful room for of games, north the hallway

You can see apple and old table here.

* * *

My Grusome Tomato Kill
An Interactive Fiction by PCAD
Release 1 / Serial number 250910 / Inform 7 build 6M62 (I6/v6.34 lib 6/12N) SD

upon closer inspection the tomato basket is rather moldy

>e
forrest
So many woods.

* * *

My Grusome Tomato Kill
An Interactive Fiction by PCAD
Release 1 / Serial number 250910 / Inform 7 build 6M62 (I6/v6.34 lib 6/12N) SD

upon closer inspection the tomato basket is rather moldy

>eat apple
It's rotten

>l
Classroom
It's a delightful room for of games, north the hallway

You can see apple here.

* * *

My Grusome Tomato Kill
An Interactive Fiction by PCAD
Release 1 / Serial number 250910 / Inform 7 build 6M62 (I6/v6.34 lib 6/12N) SD

upon closer inspection the tomato basket is rather moldy

>forward
Hallway
A dark and scary hallway.

You can see funky hat here.

* * *

My Grusome Tomato Kill
An Interactive Fiction by PCAD
Release 1 / Serial number 250910 / Inform 7 build 6M62 (I6/v6.34 lib 6/12N) SD

upon closer inspection the tomato basket is rather moldy

>hop
You jump on the spot.

>s
You can't go that way.

* * *

>hop
You jump on the spot.

>x self
As good-looking as ever.

>hop
You jump on the spot.

* * *

My Grusome Tomato Kill
An Interactive Fiction by PCAD
Release 1 / Serial number 250910 / Inform 7 build 6M62 (I6/v6.34 lib 6/12N) SD

upon closer inspection the tomato basket is rather moldy

>kill tomato monster with hands
You can't see any such thing.

>kill tomato monster with shovel
ouch!

>l
Rook
It's a wonderfully huge tower! There is a forrest to the east.

a old beautiful cabinet is here

You can also see Chair and shovel here.

* * *

My Grusome Tomato Kill
An Interactive Fiction by PCAD
Release 1 / Serial number 250910 / Inform 7 build 6M62 (I6/v6.34 lib 6/12N) SD

upon closer inspection the tomato basket is rather moldy

>kill tomator with wisk
You can't see any such thing.

>kill tomato with wisk
Merr! I'm all mixed up!

    *** Hooray you won and your kitchen is tomato free! ***

Would you like to RESTART, RESTORE a saved game, QUIT or UNDO the last command?

* * *

My Grusome Tomato Kill
An Interactive Fiction by PCAD
Release 1 / Serial number 250910 / Inform 7 build 6M62 (I6/v6.34 lib 6/12N) SD

upon closer inspection the tomato basket is rather moldy

>l
upon closer inspection the tomato basket is rather moldy

>hop
You jump on the spot.

* * *

>x self
As good-looking as ever.

>s
You can't go that way.

>n
You can't go that way.

* * *

>l
upon closer inspection the tomato basket is rather moldy

>l
upon closer inspection the tomato basket is rather moldy

* * *

My Grusome Tomato Kill
An Interactive Fiction by PCAD
Release 1 / Serial number 250910 / Inform 7 build 6M62 (I6/v6.34 lib 6/12N) SD

upon closer inspection the tomato basket is rather moldy

>n
You can't go that way.

>s
Hallway
A dark and scary hallway.

You can see funky hat here.

>n
Classroom
It's a delightful room for of games, north the hallway

You can see apple here.

>n
You can't go that way.

>n
You can't go that way.

>go north
You can't go that way.

* * *

>s
Hallway
A dark and scary hallway.

You can see funky hat here.

>wear hat
(first taking funky hat)
You put on funky hat.

>i
You are carrying:
  funky hat (being worn)

* * *

My Grusome Tomato Kill
An Interactive Fiction by PCAD
Release 1 / Serial number 250910 / Inform 7 build 6M62 (I6/v6.34 lib 6/12N) SD

upon closer inspection the tomato basket is rather moldy

>open cabinet
That's already open.

>x cabinet
In cabinet is apple.

* * *

My Grusome Tomato Kill
An Interactive Fiction by PCAD
Release 1 / Serial number 250910 / Inform 7 build 6M62 (I6/v6.34 lib 6/12N) SD

upon closer inspection the tomato basket is rather moldy

>s
Hallway
A dark and scary hallway.

You can see funky hat here.

>n
Classroom
It's a delightful room for of games, north the hallway

You can see apple and old table here.

>straight
Hallway
A dark and scary hallway.

You can see funky hat here.

* * *

>s
Hallway
A dark and scary hallway.

You can see funky hat here.

>w
You can't go that way.

>n
You can't go that way.

>e
You can't go that way.

* * *

My Grusome Tomato Kill
An Interactive Fiction by PCAD
Release 1 / Serial number 250910 / Inform 7 build 6M62 (I6/v6.34 lib 6/12N) SD

upon closer inspection the tomato basket is rather moldy

>stand on chair
That's not something you can stand on.

>climb on chair
You can't see any such thing.

>l
Rook
It's a wonderfully huge tower! There is a forrest to the east.

You can see Chair here.

* * *

My Grusome Tomato Kill
An Interactive Fiction by PCAD
Release 1 / Serial number 250910 / Inform 7 build 6M62 (I6/v6.34 lib 6/12N) SD

upon closer inspection the tomato basket is rather moldy

>take apple
Taken.

>drop apple
Dropped.

>eat apple
It's rotten

>x apple
It's gross yo...

* * *

>take apple
Taken.

>eat apple
That's plainly inedible.

* * *

>take apple
Taken.

>i
You are carrying:
  apple

>eat apple
You eat apple. Not bad.

>i
You are carrying nothing.

* * *

>take apple
Taken.

>x apple
It's a red apple

* * *

My Grusome Tomato Kill
An Interactive Fiction by PCAD
Release 1 / Serial number 250910 / Inform 7 build 6M62 (I6/v6.34 lib 6/12N) SD

upon closer inspection the tomato basket is rather moldy

>take chair
Taken.

>i
You are carrying:
  Chair

* * *

My Grusome Tomato Kill
An Interactive Fiction by PCAD
Release 1 / Serial number 250910 / Inform 7 build 6M62 (I6/v6.34 lib 6/12N) SD

upon closer inspection the tomato basket is rather moldy

>take red apple
Taken.

>take green apple
You can't see any such thing.

>x red apple
The apple gleams, so happy to be picked it explodes and a green apple appears

>take apple
Taken.

>x green apple
You see nothing special about green apple.

* * *

My Grusome Tomato Kill
An Interactive Fiction by PCAD
Release 1 / Serial number 250910 / Inform 7 build 6M62 (I6/v6.34 lib 6/12N) SD

upon closer inspection the tomato basket is rather moldy

>x apple
The apple gleams, so happy to be picked it explodes!

>x apple
You can't see any such thing.

* * *

My Grusome Tomato Kill
An Interactive Fiction by PCAD
Release 1 / Serial number 250910 / Inform 7 build 6M62 (I6/v6.34 lib 6/12N) SD

upon closer inspection the tomato basket is rather moldy

>x chair
A beautful old wooden executive seat.

>x chair
A beautful old wooden executive seat.